11111111111111
1P001000000001
110010C0111001
11101000000001
10001001111001
1C0110010000C1
10010001011111
10C10000010001
11010001010101
11000101010001
11110100010101
100001000000E1
11111111111111
